\./....\../......................|............../-.......|....................|....../|\..../.............\...
...........|.-.............|.././........../........................./...........||.....................-....\
...............\.............-...................-............/.|...|.......-...............................-.
.......................................\..|-.../\....../.........|............/...|.....-.|...........\...|...
............/.-..|...\........|...........-......................\.........-........\....../....|.........|...
................-...........-|....\.................-........\........\...|.././......./......................
......................-....../.-........../........\....../..../.............-..........|.|.................|.
...|....................|.|../.......\.......|.......-...............|.......\......\....................|\...
.........\.............|.......-.....................|....................|..................-.......\-...\...
.../............-........../.||..../........-...../-.........-......./......\........|........................
....|..../.../../.....\..............-.-................../........|...../....\....\...................|......
.......\..-..................|..../..........|....................-............/...................\|../......
..-.\................../................../....\........./...\.\/.............................\|..............
.......-...............................-.......|....................|......................../...........|/...
................|...\-....-.......|/......./.......................|../.\-...-....../...\........\......\.|...
.....................-.......-....-................|.............-........-....................\....../....-..
\..|.|....-......../......../.../...................|.....................\..--...............-.......||......
.....-.\.....................-...\............../....\.......-/../|...|......../..\..................../......
....|...\......................|...|.../...|...............\...........-........................|.......--.-..
......\....|.-...........\................................|.................\..............\..|...............
...................||..................\|...................|....\............-....../........\.../.....-...-.
....................................|....|......./.\..................../..............|../.............\.....
......|...\./......../......|....\..././.......|...............................-.........../.-..\.............
.|.../....|.................-..............|..................\....../..........-..........|...|......|./.....
.........|.........../..\...|....../...................................................-......................
../....|/.............|.........../....................\.......\............./.........../.......-.........\-.
................\....................\.....-..|............-......-|...............\......\...-...............
..........|..........|...........|.../.............................-......\.....|\.........\.\.............../
.........................../...........\.............|................../.-.......-....././\.........-........
\....\................../..../.............-../......|.\.........-./..\........./.............................
.\..../..............|........../.......\........|.-.-........//\.......|.....-.../..-.....-...........-......
.......|................\.....................\.............-........./..................-...-...........\....
....../.......-......././.-.....|..........|.........|..........\............................/................
................\......\................\\.\..\........\.................................\......-/.....-......
..-...../......-.......................................|.................|......-.-...-.....\....../...-......
........................\....|.....\....|............................\..............\.......................\.
............................/|...|........\.\....\......-|......................|.....|.\-...-......-.........
\..|...........................\.................\.-................../................./..../.\..............
|.../.............\...............................|..|..-......-.......-.......|..\../.........-...........|..
...........|................\............................../.......................|..../-|...................
...\.|.\..................|.\-/....../-/..|/............\......../\.\...........\\.......-....-\..............
.................................-......./..-............|..\../..................................|/./|..../..
.../..../........|-.........|.....|..............-.................../.....|-.......|.....|...............\...
-..-...................//............................./.........-...............-.........|.../...........\...
.............././\......|..............\..................|...............-............................-......
/.........|/.....-../|......-.........|..-.-...........-........|..........-..................................
.............\.......|/........../.....|.......-....-....../......-...................-....|........\.........
\...|.|.../..|....../....-.........................-..............|.....\.......-........\........-....|......
-.-..\..........|........................./..........|..-./...........................|...........-........-..
....\./..............-.........|......./.-..............-.-../\........|..|.........-..............\...\.../..
..|...........\...../......../.../.........\....../....-..................................|/............-...|.
.../.........|..-................|..........|....\/..........|..|\.......|...........|........................
........../.............\...\.............................-...................|................-...-..........
.....................-.................................../../.............................-../................
.-........./......|........-...../...................\..|-........-...\..........././||.......................
.........|../../.....-...........-....-..-...|.............................\..................................
...................-.....\......../............./...............-.......\.........../........|............../.
.|\.............................................-.........-....|.....\..................-..-.......\..........
/................/....\.........\|...............-.............|......./...........-.....\........-.......--..
..........-........\........\-...\....\\........../...|./.........................\.....|.................\../
............................-.|............................\...\../..........................\......./...../..
.....//.......|..\.........-..\.........-....\..-..\.....-.....//.../.........................................
................................|....|..\............/|./.\....|.............-..\|................./..........
.....|.......-.............-../...../.........|../.....................|........................./.....|......
.-...\...../................\.-........|..|...|...|.........\|......|...../...../..........\................|.
.../../............-.........|................\.....\....-...................../.../...........-...|...../|...
..-..........-.......-.............\..............-..............\.......|....................................
..|................/........................-...................../.................................|......../
...../........\......./....../......||.......|-...............-.....-............../../.......................
...\..../...................-........\.........\............................/....|.........-..........-.......
.../................\....\..|-...........................\.-..-......|.|.-/.....-............./...............
../............\...........................-../....|....................-..............|........./......|...\\
.........................\..................|..\........................./....................\...............
/.............|.....................-.....\.....-..|............/..........|./...|....-...-....|-....../......
.\.-.....\............././.........................\..........-......................|........\...............
........\../............../......\.....\..-............|............\............../..|.......................
....-../....\..................................-......../...|................................................-
.......................\............-...................../.........\............-../.........\/..|../....-/|.
..../.............|....../............-.|......../.....................|...../..|.....-.............../.......
....................|\...........-...................................../.......................-...-..|..\.|/.
......................-....-\........../..............\.......-....\.....|...............\.........-..........
.|......../.....|.........||.................../.....\...|.........\........../........\............../.......
.-............/-..........-...........\..........\.......-....................................................
.....|/....-.../......-......................../.|./...\.......\/......./......../..\...../...|...|.........\-
.............../..\.../-......|\\......../............../............|/......................./.......\.......
.....\.-./....../............/..-................../....\..................-.................|.......-/..-....
.-................-..-...........................-..|............-.................../...........-...........|
-......\......|......\............../.............../...-/.../....\.........................-.....|.....-.....
.......\.....--.-............................\..........-./........||......|..\...../..../................|...
.............-.....|..../.......|............|....................-......\.............../|...............|...
............|........../........|....................-....|....../.........\..........-........-..-...........
..............|.................-....|...........\.|.../.........../..........-......\|.............\..-......
......-............\.......\....................................................|\..\.......................-.
................||...........\...-\/..|..............\.........................../.......\.|.............|...|
....-...................-...../....|............\.../.........-..../....\........../..../.|..........\........
........-.....\........../....|.........\......./...........\.......-..|............../...........-..|........
.................../.....-...........|....-...\......\...|...|...........................\.......||......\|...
......-.........|.....\....-..........|.......\....\..................................../........|...|./......
..................\.........../.............../.................../.........-.......-..../............/\.../..
........\...\...\....../.......\\........../............../.-.................../........|..............-.....
....../........................|................-.-......-....|......\\.-...-.|..........|..../...............
/.......-.....|.....\...................|...../..............|......|.../....................\.....|..........
|.\....-...............|/....|........../....................................\.-............................/.
.......................-...............-.|...................|......\.....-\..|.......-......./\.....-......-.
................................|../.................................-........-...................|...........
.....-.........\..-................./...........|...............|....................\/../../........|.-......
............................../......./.\/........./..|..............|.......................\................
......./.-.......\...........-...............|............|.............|..........|.|..........|.........--..
............-..............-.............\./...|.....|................|..........|/.............\.............
.../....................-........-.................../.....\.............-...................\................